111111111111111
1000000001
10C0000001
1000000001
1000011111
1000000001
10000C0001
100001000111111
100C00000000001
100000000000001
1000000C000111
1000000000000E1
10C000000000001
10000P000000001
111111111111111
