111111111111111
100000000000001
10C000000000001
100000000000001
100001111000001
100000000000001
1000000000C0001
100000001110001
100000000000001
100C00000000001
100000000000001
1000000C0000001
1000000000000E1
10C000000000001
10000P000000001
111111111111111
