1111111111111
10C0000000001
1000000000001
1P00000000001
1111111111111
