1111111111111
10C0000000001
1000000000001
1P0000E000001
1111111111111
