1111111111111111
1000000000000001
10C00000000000C1
1000000000000001
1000011110000001
1000000000000001
1000000000C00001
1000000011100001
1000000000000001
100C000000000001
1000000000000001
1000000C00000001
1000000000000E01
10C0000000000001
10000P0000000001
1111111111111111
